0 0 0 0 0 0 0 0 0 0 0 0 0 0 0 0 0 0 0 0 0 0 0 0
0 0 0 0 0 0 0 0 0 0 0 a a 0 0 0 0 0 0 0 0 0 0 0
0 0 0 0 0 0 0 0 0 0 0 1 1 0 0 0 0 0 0 0 0 0 0 0
0 0 0 1 1 1 1 1 1 1 1 1 1 1 1 1 1 1 1 1 1 0 0 0
0 0 0 1 0 0 2 0 2 0 0 1 1 0 0 2 0 2 0 0 1 0 0 0
0 0 0 1 0 0 2 2 2 0 0 1 1 0 0 2 2 2 0 0 1 0 0 0
0 0 0 1 0 0 0 0 0 0 0 1 1 0 0 0 0 0 0 0 1 0 0 0
0 0 0 1 0 0 0 2 2 2 2 1 1 2 2 2 2 0 0 0 1 0 0 0
0 0 0 1 0 0 0 2 0 0 0 0 0 0 0 0 2 0 0 0 1 0 0 0
0 0 0 1 0 0 4 4 4 0 0 0 0 0 0 0 6 0 0 0 1 0 0 0
0 0 0 1 0 0 4 0 4 0 0 0 0 0 0 0 6 0 0 0 1 0 0 0
0 4 4 4 4 4 4 0 4 4 2 0 0 2 6 6 6 6 6 6 6 6 6 0
0 4 b 4 b 4 b 4 b 4 0 0 0 0 6 3 3 3 6 3 6 3 6 0
0 4 g 4 g 4 g 4 g 4 4 1 1 6 6 6 6 6 6 6 6 6 6 0
0 0 0 0 0 0 0 0 0 0 0 0 0 0 0 0 0 0 0 0 0 0 0 0