0 0 0 0 0 0 0 0 0 0 0 0 0 0 0 0 0 0 0 0 0 0 0 0
0 0 0 0 2 2 2 2 2 2 2 2 2 2 2 2 2 2 2 2 2 2 0 0
0 0 0 0 2 0 0 0 0 0 0 0 0 0 0 0 0 0 0 0 0 1 0 0
0 0 0 0 2 0 0 0 0 0 0 0 0 0 0 0 0 0 0 0 6 6 6 0
0 0 0 0 1 0 0 0 0 0 0 1 1 1 1 0 0 0 0 0 6 T 6 0
0 5 5 5 5 5 5 5 0 0 0 1 0 0 1 2 2 0 0 0 6 6 6 0
0 5 3 3 5 3 3 5 0 0 1 a 1 0 1 2 2 0 2 2 6 T 6 0
0 5 5 5 5 5 5 5 0 0 0 1 0 0 1 0 0 0 2 0 6 6 6 0
0 5 T T 5 T T 5 0 0 1 1 1 0 1 0 0 0 2 0 0 6 0 0
0 5 5 5 5 5 5 5 0 0 1 1 1 0 1 0 0 0 2 0 6 6 6 0
0 5 3 3 5 3 3 5 0 0 1 1 1 0 1 2 2 0 2 2 6 T 6 0
0 5 5 5 5 5 5 5 0 0 1 1 1 0 1 2 2 0 0 0 6 6 6 0
0 5 T T 5 T T 5 0 0 1 1 1 0 1 0 0 0 0 0 6 T 6 0
0 5 5 5 5 5 5 5 1 1 1 1 1 0 1 1 1 1 1 1 6 6 6 0
0 0 0 0 0 0 0 0 0 0 0 0 0 0 0 0 0 0 0 0 0 0 0 0