0 0 a 0 0 0 0 0 0 0 0 0 0 0 0 0 0 0 0 0 0 0 0 0
0 5 5 5 5 5 5 1 1 1 1 1 1 1 1 1 1 1 1 1 1 1 0 0
0 5 T T T T 5 0 1 0 0 0 0 1 0 0 0 0 0 0 0 1 0 0
0 5 T T T T 5 0 1 0 0 0 0 1 0 4 4 4 4 4 0 1 0 0
0 5 T T T T 5 0 1 0 0 0 0 1 0 4 3 3 3 4 0 1 0 0
0 5 5 5 5 5 5 0 1 0 0 0 0 1 1 4 3 3 3 4 1 1 0 0
0 5 T T T T 5 0 1 0 0 0 0 1 0 4 4 4 4 4 0 1 0 0
0 5 T T T T 5 0 1 0 0 0 0 1 0 0 0 0 0 0 0 1 0 0
0 5 5 5 5 5 5 0 1 1 1 1 1 1 1 1 1 1 1 1 1 1 0 0
0 0 0 0 0 0 0 0 1 0 0 0 0 1 0 0 0 1 0 0 0 1 0 0
0 1 1 1 1 1 1 0 1 0 0 0 0 1 0 0 0 1 0 1 1 1 1 0
0 1 1 1 1 1 1 0 1 0 0 0 0 1 1 1 1 1 0 1 1 1 1 0
0 1 1 1 1 1 1 1 1 0 0 0 0 1 0 0 0 1 0 1 1 1 1 0
0 1 1 1 1 1 1 0 1 1 1 1 1 1 1 1 1 1 0 1 1 1 1 0
0 0 0 0 0 0 0 0 0 0 1 1 0 0 0 0 0 0 0 0 0 0 0 0