0 0 0 0 0 0 0 0 0 0 0 0 0 0 0 0 0 0 0 0 0 0 0 0
0 i 3 3 0 0 0 2 2 0 0 0 0 0 0 2 2 0 0 0 0 0 0 0
0 6 T 6 0 0 0 2 2 0 0 0 0 0 0 2 2 0 0 0 2 2 2 0
0 6 6 1 1 1 1 1 1 1 1 1 1 1 1 1 1 1 1 1 1 2 2 0
0 0 0 1 0 0 0 0 0 0 0 0 0 0 0 0 0 0 0 0 2 2 2 0
0 0 0 1 0 0 0 0 0 0 0 0 0 0 0 0 0 0 0 0 0 0 0 0
0 2 2 1 0 0 0 0 2 2 1 1 1 1 1 1 1 1 1 1 1 0 0 0
0 2 0 1 0 0 0 0 2 0 1 0 0 0 0 0 0 0 0 0 1 0 0 0
0 2 2 1 0 0 0 0 2 2 1 1 1 1 a 0 0 0 0 0 1 2 2 0
0 0 0 1 0 0 0 0 0 0 0 0 0 0 0 0 0 0 0 0 1 2 2 0
0 0 0 1 0 0 0 0 0 0 0 0 0 0 0 0 0 0 0 0 1 0 0 0
0 5 5 1 1 1 1 1 1 1 1 1 1 1 1 1 1 1 1 1 1 5 5 0
0 5 b 5 0 0 0 2 2 0 0 0 0 0 0 2 2 0 0 0 5 b 5 0
0 5 g 5 0 0 0 2 2 0 0 0 0 0 0 2 2 0 0 0 5 g 5 0
0 0 0 0 0 0 0 0 0 0 0 0 0 0 0 0 0 0 0 0 0 0 0 0